MMMMMMMMMMMMMMMMMMM
MSBBBBBBBMBBBBBBBSM
MBMMBMMMBMBMMMBMMBM
MBBBBBBBBBBBBBBBBBM
MBMMBMBMMMMMBMBMMBM
MBBBBMBBBMBBBMBBBBM
MMMMBMMMBMBMMMBMMMM
MMMMBMBBB BBBMBMMMM
BBBBBBBMMFMMBBBBBBB
MMMMBMBMMMMMBMBMMMM
MMMMBMBDBBBDBMBMMMM
MMMMBMBMMMMMBMBMMMM
MBBBBBBBBMBBBBBBBBM
MBMMBMMMBMBMMMBMMBM
MBBMBBBBBPBBBBBMBBM
MMBMBMBMMMMMBMBMBMM
MBBBBMBBBMBBBMBBBBM
MBMMMMMMBMBMMMMMMBM
MSBBBBBBBBBBBBBBBSM
MMMMMMMMMMMMMMMMMMM